***************************************
* *************************************
* *               *****         *******
*   ** *** ***** ****** ******* *******
****** *** ***** ****** ******* *******
****** *** ***** ****** ******* *******
******     ***** **     ****      *****
******** ****    ** ******** **** *****
*****       * ** ** ********      *****
**    ***** * **        **** **********
*** * ***** * *** ***** **** **********
*** *         *** *****             ***
*** ****** ****** ***** *********** ***
*** ****** ******             ***** ***
***        ********* ******** ***** ***
***** **** *********       **    ** ***
***** **** ********* ***** ** ***** ***
***** **** *         *****          ***
*****        ************* ************
***************************************